10001001101010201
01001201010102101
00120120100101001
10001001101010201
10001001101010201
10001001101010201
01001201010102101
00120120100101001
01001201010102101
00120120100101001
10001001101010201
10001001101010201
01001201010102101
10001001101010201
01001201010102101
10001001101010201
01001201010102101
00120120100101001